%%%%%%%%%%%%%%%%%%%%
%..    %  G %.    .%
%.%%   %%  %% . %%.%
%.%. %       .%  %.%
% %%.% %%%%%% % %% %
%        P         %
%%%%%%%%%%%%%%%%%%%%
