%%%%%%%%%%%%%%%%%%%%
%......%  G %......%
%.%%...%%  %%...%%.%
%.%..%........%..%.%
%.%%.%.%%%%%%.%.%%.%
%........P.........%
%%%%%%%%%%%%%%%%%%%%
